E E N N N N
E E N N Os N
N N N N N N
N N N N N N
N N N Os Os Os
N N N N N N
N N N N C C
N N N N C C
